13,3,13,5,5,1,5,5,1,3
11,12,1,1,3,10,9,7,8,2
8,5,4,4,6,10,8,1,4,6
12,5,5,5,5,6,8,6,9,3
9,5,5,5,5,5,6,9,6,10
8,5,5,1,1,1,1,2,9,2
8,3,9,2,14,14,8,6,12,6
10,14,10,8,1,3,12,3,9,3
8,5,4,2,8,4,3,14,10,10
12,5,7,12,4,7,12,5,6,14